................
.k  m          .
......     &   .
. m  .         .
. .  .         .
. .  .     .....
. .  .     . ! .
.=.            .
................
